##########
#        #
#  ####  #
#  #     #
#  #  ####
#  #     #
#  #######
#        #
##########
